8
272
0	0	200	200	7	1	2	3	13	14	15	16	
200	0	200	200	4	1	4	5	6	
400	0	200	200	4	6	7	8	9	
600	0	200	200	5	9	10	11	12	18	
0	200	200	200	2	0	15	
200	200	200	200	1	0	
400	200	200	200	0	
600	200	200	200	1	17	
