0	0	0	800	272	4	0
01	0	0	400	136	4	0
011	0	0	200	68	0	2	19	24
012	200	0	200	68	0	2	32	35
013	0	68	200	68	0	6	2	3	15	16	21	24
014	200	68	200	68	0	5	4	6	23	33	35
02	400	0	400	136	4	0
021	400	0	200	68	0	4	29	30	31	34
022	600	0	200	68	0	2	25	28
023	400	68	200	68	0	2	6	7
024	600	68	200	68	0	4	10	18	25	26
03	0	136	400	136	4	0
031	0	136	200	68	0	5	1	13	14	15	27
032	200	136	200	68	0	3	1	5	27
033	0	204	200	68	0	1	0
034	200	204	200	68	0	1	0
04	400	136	400	136	4	0
041	400	136	200	68	0	3	8	9	22
042	600	136	200	68	0	6	9	11	12	18	25	26
043	400	204	200	68	0	0
044	600	204	200	68	0	2	17	20
