0	0	0	800	272	4	0
01	0	0	400	136	4	0
011	0	0	200	68	0	0
012	200	0	200	68	0	0
013	0	68	200	68	0	4	2	3	14	16
014	200	68	200	68	0	2	4	6
02	400	0	400	136	4	0
021	400	0	200	68	0	0
022	600	0	200	68	0	0
023	400	68	200	68	0	2	6	7
024	600	68	200	68	0	2	10	18
03	0	136	400	136	4	0
031	0	136	200	68	0	4	1	13	15	16
032	200	136	200	68	0	2	1	5
033	0	204	200	68	0	2	0	15
034	200	204	200	68	0	1	0
04	400	136	400	136	4	0
041	400	136	200	68	0	2	8	9
042	600	136	200	68	0	4	9	11	12	18
043	400	204	200	68	0	0
044	600	204	200	68	0	1	17
