8
400
0	0	200	200	8	9	10	11	12	24	29	41	71	
200	0	200	200	11	12	13	14	25	42	43	44	54	72	73	74	
400	0	200	200	17	15	16	17	18	26	30	31	45	46	47	55	56	57	75	76	77	81	
600	0	200	200	13	19	20	21	22	27	32	48	49	51	78	79	80	81	
0	200	200	200	12	1	2	3	8	23	28	39	40	50	53	69	70	
200	200	200	200	8	1	4	7	37	38	66	67	68	
400	200	200	200	10	1	5	7	35	36	52	60	63	64	65	
600	200	200	200	10	0	1	6	7	33	34	58	59	61	62	
