8
272
0	0	200	200	11	1	2	3	13	14	15	16	19	21	24	27	
200	0	200	200	9	1	4	5	6	23	27	32	33	35	
400	0	200	200	9	6	7	8	9	22	29	30	31	34	
600	0	200	200	8	9	10	11	12	18	25	26	28	
0	200	200	200	2	0	14	
200	200	200	200	1	0	
400	200	200	200	0	
600	200	200	200	2	17	20	
