8
272
0	0	200	200	17	1	2	3	13	14	15	16	19	21	24	27	36	37	38	39	40	41	
200	0	200	200	12	1	4	5	6	23	27	32	33	35	38	49	50	
400	0	200	200	12	6	7	8	9	22	29	30	31	34	45	47	48	
600	0	200	200	12	9	10	11	12	18	25	26	28	42	43	44	46	
0	200	200	200	3	0	14	39	
200	200	200	200	1	0	
400	200	200	200	0	
600	200	200	200	2	17	20	
