8
400
0	0	200	200	7	9	10	11	12	24	29	41	
200	0	200	200	8	12	13	14	25	42	43	44	54	
400	0	200	200	13	15	16	17	18	26	30	31	45	46	47	55	56	57	
600	0	200	200	9	19	20	21	22	27	32	48	49	51	
0	200	200	200	10	1	2	3	8	23	28	39	40	50	53	
200	200	200	200	5	1	4	7	37	38	
400	200	200	200	6	1	5	7	35	36	52	
600	200	200	200	6	0	1	6	7	33	34	
