0	0	0	784	400	4	0
01	0	0	392	200	4	0
011	0	0	196	100	0	4	9	11	24	41
012	196	0	196	100	0	2	13	54
013	0	100	196	100	0	5	9	10	11	12	29
014	196	100	196	100	0	7	12	13	14	25	42	43	44
02	392	0	392	200	4	0
021	392	0	196	100	0	5	26	31	45	55	56
022	588	0	196	100	0	2	32	49
023	392	100	196	100	0	10	15	16	17	18	30	31	45	46	47	57
024	588	100	196	100	0	8	19	20	21	22	27	32	48	51
03	0	200	392	200	4	0
031	0	200	196	100	0	4	23	28	40	53
032	196	200	196	100	0	1	7
033	0	300	196	100	0	7	1	2	3	8	23	39	50
034	196	300	196	100	0	4	1	4	37	38
04	392	200	392	200	4	0
041	392	200	196	100	0	1	7
042	588	200	196	100	0	1	7
043	392	300	196	100	0	5	1	5	35	36	52
044	588	300	196	100	0	5	0	1	6	33	34
