0	0	0	800	272	4	0
01	0	0	400	136	4	0
011	0	0	200	68	0	4	19	24	40	41
012	200	0	200	68	0	3	32	35	49
013	0	68	200	68	0	8	2	3	15	16	21	24	40	41
014	200	68	200	68	0	7	4	6	23	33	35	50	51
02	400	0	400	136	4	0
021	400	0	200	68	0	7	29	30	31	34	45	47	48
022	600	0	200	68	0	5	25	28	42	43	44
023	400	68	200	68	0	2	6	7
024	600	68	200	68	0	5	10	18	25	26	46
03	0	136	400	136	4	0
031	0	136	200	68	0	9	1	13	14	15	27	36	37	38	39
032	200	136	200	68	0	5	1	5	27	38	51
033	0	204	200	68	0	2	0	39
034	200	204	200	68	0	1	0
04	400	136	400	136	4	0
041	400	136	200	68	0	3	8	9	22
042	600	136	200	68	0	6	9	11	12	18	25	26
043	400	204	200	68	0	0
044	600	204	200	68	0	2	17	20
