0	0	0	1552	416	4	0
01	0	0	776	208	4	0
011	0	0	388	104	0	0
012	388	0	388	104	4	0
0121	388	0	194	52	0	0
0122	582	0	194	52	0	0
0123	388	52	194	52	0	0
0124	582	52	194	52	0	6	2	15	34	36	43	47
013	0	104	388	104	4	0
0131	0	104	194	52	0	5	7	8	22	23	24
0132	194	104	194	52	0	5	9	10	11	25	26
0133	0	156	194	52	0	7	0	5	6	7	22	23	24
0134	194	156	194	52	0	4	0	10	25	26
014	388	104	388	104	4	0
0141	388	104	194	52	0	2	12	13
0142	582	104	194	52	0	7	1	14	16	34	35	42	47
0143	388	156	194	52	0	2	0	12
0144	582	156	194	52	0	3	0	16	33
02	776	0	776	208	4	0
021	776	0	388	104	4	0
0211	776	0	194	52	0	0
0212	970	0	194	52	0	1	17
0213	776	52	194	52	0	5	2	37	44	48	49
0214	970	52	194	52	0	2	17	49
022	1164	0	388	104	4	0
0221	1164	0	194	52	0	0
0222	1358	0	194	52	0	0
0223	1164	52	194	52	0	0
0224	1358	52	194	52	0	3	4	40	41
023	776	104	388	104	4	0
0231	776	104	194	52	0	5	3	27	31	38	49
0232	970	104	194	52	0	6	3	18	19	28	29	49
0233	776	156	194	52	0	3	0	27	31
0234	970	156	194	52	0	5	0	18	19	28	29
024	1164	104	388	104	4	0
0241	1164	104	194	52	0	2	20	30
0242	1358	104	194	52	0	2	21	32
0243	1164	156	194	52	0	4	0	20	30	39
0244	1358	156	194	52	0	3	0	21	32
03	0	208	776	208	4	0
031	0	208	388	104	4	0
0311	0	208	194	52	0	2	45	46
0312	194	208	194	52	0	0
0313	0	260	194	52	0	0
0314	194	260	194	52	0	0
032	388	208	388	104	0	0
033	0	312	388	104	0	0
034	388	312	388	104	0	0
04	776	208	776	208	0	0
