54
432
0	0	200	200	3	82	83	84	
200	0	200	200	5	59	61	82	85	86	
400	0	200	200	5	60	62	82	87	88	
600	0	200	200	2	55	82	
800	0	200	200	6	63	64	65	66	89	90	
1000	0	200	200	6	67	68	69	91	92	93	
1200	0	200	200	3	70	71	72	
1400	0	200	200	10	1	5	23	24	25	26	27	56	73	76	
1600	0	200	200	11	1	6	28	29	30	57	58	74	75	94	95	
1800	0	200	200	5	77	79	80	96	97	
2000	0	200	200	6	2	32	33	78	81	98	
2200	0	200	200	2	2	42	
2400	0	200	200	4	2	7	35	38	
2600	0	200	200	7	0	3	4	8	41	43	45	
2800	0	200	200	6	0	3	9	46	47	54	
3000	0	200	200	3	9	48	53	
3200	0	200	200	0	
3400	0	200	200	5	10	11	50	51	52	
0	200	200	200	1	82	
200	200	200	200	1	82	
400	200	200	200	1	82	
600	200	200	200	2	12	82	
800	200	200	200	3	12	89	90	
1000	200	200	200	4	12	91	92	93	
1200	200	200	200	2	12	22	
1400	200	200	200	2	12	22	
1600	200	200	200	3	12	94	95	
1800	200	200	200	3	12	96	97	
2000	200	200	200	3	12	31	98	
2200	200	200	200	6	12	13	17	36	37	42	
2400	200	200	200	5	13	16	17	18	34	
2600	200	200	200	9	14	15	19	20	21	39	40	41	44	
2800	200	200	200	2	15	20	
3000	200	200	200	2	15	49	
3200	200	200	200	1	15	
3400	200	200	200	1	15	
0	400	200	200	0	
200	400	200	200	0	
400	400	200	200	0	
600	400	200	200	0	
800	400	200	200	0	
1000	400	200	200	0	
1200	400	200	200	0	
1400	400	200	200	0	
1600	400	200	200	0	
1800	400	200	200	0	
2000	400	200	200	0	
2200	400	200	200	0	
2400	400	200	200	0	
2600	400	200	200	0	
2800	400	200	200	0	
3000	400	200	200	0	
3200	400	200	200	0	
3400	400	200	200	0	
