0	0	0	784	192	4	0
01	0	0	392	96	4	0
011	0	0	196	48	0	1	11
012	196	0	196	48	0	0
013	0	48	196	48	0	6	1	6	11	12	30	31
014	196	48	196	48	0	4	13	22	23	32
02	392	0	392	96	4	0
021	392	0	196	48	0	0
022	588	0	196	48	0	0
023	392	48	196	48	0	0
024	588	48	196	48	0	1	41
03	0	96	392	96	4	0
031	0	96	196	48	0	3	2	5	31
032	196	96	196	48	0	11	2	7	14	15	22	23	24	25	26	29	33
033	0	144	196	48	0	1	0
034	196	144	196	48	0	7	0	8	15	24	25	26	29
04	392	96	392	96	4	0
041	392	96	196	48	0	4	18	27	28	36
042	588	96	196	48	0	7	4	9	10	20	21	38	39
043	392	144	196	48	0	7	0	16	17	27	28	34	35
044	588	144	196	48	0	6	0	3	9	19	37	40
