0	0	0	784	192	4	0
01	0	0	392	96	4	0
011	0	0	196	48	0	1	11
012	196	0	196	48	0	0
013	0	48	196	48	0	4	1	6	11	12
014	196	48	196	48	0	3	13	22	23
02	392	0	392	96	0	0
03	0	96	392	96	4	0
031	0	96	196	48	0	2	2	5
032	196	96	196	48	0	9	2	7	14	15	22	23	24	25	26
033	0	144	196	48	0	1	0
034	196	144	196	48	0	6	0	8	15	24	25	26
04	392	96	392	96	4	0
041	392	96	196	48	0	3	18	27	28
042	588	96	196	48	0	5	4	9	10	20	21
043	392	144	196	48	0	5	0	16	17	27	28
044	588	144	196	48	0	4	0	3	9	19
